###################
#                 #
#    P      O     #
#       X         #
#   X       X     #
#                 #
###################
