############
#   O X#   #
#O  XXXX   #
#          #
#     P    #
#     C    #
############
