###############
#     X   O   #
#    XX       #
#  XX   X     #
#   X P XX    #
#    XX       #
#     X       #
###############
