############ ##############
####                 ######
##                      ###
         P                 
##     X      O         ###
#                        ##
###                  ######
############ ##############
